000000000000000000000000000000000000
000000000000E00000000000000000000000
000000000E00E00000000000000000000000
000000000000E00000000000000000000000
000000000000000000000000000000000000
000000000000000000000000000000000000
000000000000000000000000000002130000
002111300000000000000000000000000000
0000000E0000000000000000000000000000
000000000000000002111113000000000000
X000000000000000X0000000000000000000
021111111111111300000000000000213000