000000000000000000000000000000000000
000000000000000000000000000000000000
000000000000000000000000000000000000
000000000000000000000000000000000000
000000000000000000000000000000000000
000000000000000000000000000000000000
000000000000000000000000000002130000
002111300000000000000000000000000000
000000000000000000000000000000000000
000000000000000002111113000000000000
000000000000000000000000000000000000
211130213002111300000000000000213000